##################################
#**1*****************************#
#**************m*****************#
#********************************#
#********************************#
#*************m***********m******#
#**2*****************************#
#********************************#
#*************m******************#
#**3*****************************#
#************m*******************#
#********************************#
##################################